NotInWebCache=非 Web 环境下无法使用该缓存管理器。
NullReference=引用的对象为空。
ArgumentNull=参数 {0} 为空。
ArgumentInvalid=参数 {0} 无效。
ArgumentOutOfRange=索引值超出了给定的范围。
MethodNotFound=未找到指定的方法 {0}。
Hour=小时
Minute=分钟
Second=秒
SerializationError=序列化过程中发生错误。
DeserializationError=反序列化过程中发生错误。
SerializationTokenInvalid=数据头未通过验证。
UnableProcessExpression=无法处理类型: {0}。
NotInterfaceType=非接口类型 {0}。
NotExpectedType=非预期的类型 {0}。
NotConcreteType=非实现类。
NoDefaultConstructor={0} 必须并且只能有一个公共的默认构造函数。
NoDefaultOrDefaultValueConstructor=没有公共的或全部参数具有默认值的默认构造函数。
NoMatchConstructor=没有匹配的构造函数。
ConstructorHasParameterOfValueType=包含值类型的参数 {0}。
CollectionHasEmptyItem=集合中有一个元素为 null。
RecursiveInvoke=对该对象递归调用。
PropertyValueLengthNotMatch=names 和 values 数组的长度不匹配。
UnableReadCacheItem=无法读取缓存数据。
UnableSaveCacheItem=无法保存缓存数据。
JsonExpected=预期值为 {0}，却获得到 {1}。
JsonExpectedArray=预期值为数组的分隔符，却获得 {0}。
JsonNullableType=读取到 null 值，无法转换为 {0} 类型。
SerializeError=序列化类型 {0} 时出错。
DeserializeError=将值 {0} 反序列化为类型 {1} 时出错。
ParameterLessConstructor=类型 {0} 没有无参数的默认构造函数。
SourceCanotReadDestCanotWrite=源不可读或目标不可写。
UnableReadConfiguration=无法读取配置 {0}。
LoopReferenceSerialize=序列化时检查到对象 {0} 被循环引用。
NotNewExpression=表达式 {0} 不能用来构造 NewExpression。
InterfaceNoBaseType=接口类型不允许设置父类类型。
UnableSaveAssembly=未指定 OutputAssembly 属性，因此无法将程序集保存到磁盘。
UnableLoadAssembly=无法加载程序集 {0}。
AopTypeMustNotSeald=类型 {0} 不能是密封的。
AopMemberMustBeVirtual=方法 {0} 必须为公共可重写(C# 为 Virtual，VisualBasic 为 Overridable)。
AopCanotCreateProxy=Aspect 无法为类型 {0} 创建代理类。
AopCanotCreateProxy_Sealed=Aspect 无法为类型 {0} 创建代理类，因为该类型是密封的。
StreamNotSupportRead=流对象未提供读操作。
StreamNotSupportWrite=流对象未提供读操作。
MethodNotOverride=所定义的方法在父类中未标记virtual、abstract或override。
AlgorithmNotSupported=不支持 {0} 密码算法。
CacheServerAnomaly=缓存服务器异常。
KeyMustBeStringable=Key 必须为可字符串化的类型，如 String、Int32、DateTime 等等。
UnableCreateCachedDelegate=无法为 {0} 创建缓存态委托。
LoopResolveSameType=检测到循环反转类型为 {0} 的对象，已被终止。
NotFoundRegisterForType=没有在容器中发现 {0} 的注册。
NotSerializeTask=不能序列化类型 {0}。
OnlyImplOneInterface=使用 IRepeatableService 标记服务时，类型 {0} 只允许实现一个拥有方法的接口。