BatcherException=批量写入数据时出错：{0}
BatcherDataTable=表的名称为空，程序无法确定写入的表。
FailInBackup=数据库备份时出错：{0}
FailInExecute=执行命令时失败：{0}
FileNotFound=没有找到文件 "{0}"。
RegistryInvalid=无效的注册表键名。
FailInDataParse=数据解析失败。
ConverterNotSupported=不支持类型 {0} 与数据类型 {1} 之间的转换。
NonRequiredAttribute=未指定配置所必须的属性 {0}。
UnableCreateSequence=无法创建序列 {0}。
AssemblyDbPfNull=DbProviderFactory 为空，请检查程序集 {0} 是否存在。
StandardDbPfNull=DbProviderFactory 为空，请检查 providerName 或相关的程序集是否存在。
UnknownSchemaCategory=未知的 Schema 类型，请使用 SchemaCategoryAttribute 标注该分类。
SchemaNotSupported=不支持架构 {0}。
SchemaGetFaild=无法获取架构 {0} 的数据。
SchemaQueryNotSupported=架构不支持对元数据 {0} 的查询。
SyntaxParseNotSupported=没有提供 "{0}" 的语法解析。
UnableInitCommand=无法初始化 SelectCommand、InsertCommand、UpdateCommand 或 DeleteCommand。
NonInstanceConfigurationSection=应用程序配置文件中没有数据库实例配置节。
InstanceConfigurationInvalid=无效的数据库实例配置项 {0}。
ProviderSettingNotFound=没有找到 {0} 的提供者配置。
ProviderNotSupported=Database 的构造函数需要指定一个 IProvider 实例。
MoreFieldCount=查询返回的列数大于1。
UnableGetDatabaseScope=无法获取当前线程的 DatabaseScope。可能受 Linq 延迟查询的影响，IDatabase 已经释放了 DatabaseScope 实例。
NotMappingDbType=类型 {0} 的属性 {1} 不支持从数据类型转换。
UnableOpenConnection=无法打开数据库连接，请检查服务器是否正常。
UnableCloseConnection=无法关闭数据库连接，请检查服务器是否正常。
ConnectionError=未知的数据库连接错误，请检查服务器是否正常。
UnableCastRowMapper=数据类型不匹配，{0} 无法读取为类型 {1}。
PropertyTypeIsNull=类型 {0} 的属性 {1} 的类型为空。
InstallProviderAssembly=必须引用 {0} 中的任意一个文件作为驱动。
ProviderNoFound={0} 未找到，请下载相关的程序进行安装。
RestrictionNotSupportedOfMember=不能使用 {0} 限制查询，仅能使用 {1} 进行限制查询。
RestrictionNotSupportedOfMetadata=不能对 {0} 使用限制查询。
NoMatchRecordWrapperMethod=IRecordWrapper没有提供与类型 {0} 相匹配的方法。