NotRelationProperty=实体的属性 {0} 不是关联型属性。
FailInEntityRemove=无法执行实体的移除操作。
FailInEntityCreate=无法执行实体的创建操作。
FailInEntityUpdate=无法执行实体的更新操作。
FailInEntityInsert=无法执行实体的插入操作。
FailInEntityMove=无法执行实体的移动操作。
FailInEntityMoveWildly=无法完成实体的移动，即将移动的实体是参照实体的父向实体。
FailInEntitySwap=无法执行实体的交换操作。
FailInEntityShiftUp=无法执行实体的上移操作。
FailInEntityShiftDown=无法执行实体的下移操作。
DisaccordArgument=所指定的参数长度与实体定义的主键长度不相符。定义的长度为{0}，实际为{1}。
WhereExistence=已经使用了 Where。
EntityTreeRequiredField=类型 {0} 缺少实体树必须的属性：{1}。
FailInTranslateExpression=表达式解析失败，无法执行查询。
TranslatorNotSupported=未提供 {0} 类型的 ELinq 翻译器。
NodeTranslateNotSupported=未提供节点 {0} 的解析。
MemberTranslateNotSupported=未提供成员 {0} 的解析。
MethodTranslateNotSupported=未提供方法 {0} 的解析。
NewTranslateNotSupported=未提供构造 {0} 的解析。
UnaryTranslateNotSupported=未提供一元操作 {0} 的解析。
ValueTranslateNotSupported=未提供值 {0} 的解析。
ScalarTranslateNotSupported=非标量影射表达式无法解析为 SQL。
EntityQueryInvalid=查询表达式无效。
UnknowAggregateType=未知的聚合类型: {0}。
ExpressionNotSequence=表达式 {0} 不是一个序列。
NotDefinedPrimaryKey=未定义任何主键。
NotDefinedReference=引用列未定义。
PropertyNotFound=无法获取名称为 {0} 的属性。
NotDefinedRelationship=该关联属性未定义任何关系。
NotDefinedRelationshipDirection=未定义关系符。
MetedataLengthValidate=值的长度超出元数据列 {0} 的定义长度。
NotEntityInstance={0} 不是 IEntity 的实例。
FaildInEntityTreeFieldType=类型 {0} 中的 {1} 属性的类型必须使用 {2}。
UnableConvertComplexType=无法将数据转换为类型 {0}，缺少与之对应的转换器。
DisUpdatePrimaryProperty=不允许修改主键的值。
NoneEntityTreeMetadata=实体类没有标注 EntityTreeMappingAttribute 特性。
InvalidRegisterExpression=无效的属性注册表达式。
InvalidCastPropertyValue=属性不支持类型 {0} 的转换操作。
DeleteKeyNotNullable=作为删除标记的字段不能为可空类型。
MustAssignRewriterInterface=类型 {0} 必须分配 IBindAfterRewriter 或 IBindBeforeRewriter 接口。
EntityInvalidate=实体验证失败。
ValidationUniqueCode=字段 {0} 不是唯一的编码。
NotSupportBatcher=此数据库不支持批量插入。
InvalidOrderExpression=表达式中不允许出现 OrderBy、ThenBy、OrderByDescending 和 ThenByDescending 以外的其他方法。
InvalidBatchOperation=批量操作提供 Insert、Update 和 Delete 方法。
MustBeNewExpression=selector 表达式必须为 NewExpression。
NoAnyField=未指定任何插入或更新的列。
MethodMustInExpression=方法必须在表达式中使用。
ClassNotImplInterface=类未实现 {0} 接口。
RelationNameRepeated=关系映射的名称重复。
IDCardValideError=字段 {0} 不是有效的身份证号码。
MobileValideError=字段 {0} 不是有效的手机号码。
TelhponeValideError=字段 {0} 不是有效的电话号码。
WebSiteValideError=字段 {0} 不是有效的网址。
ZipCodeValideError=字段 {0} 不是有效的邮政编码。
EmailValideError=字段 {0} 不是有效的电子邮件。
InvalidOperationAsNoTracking=使用 AsNoTracking 模式时不允许此操作。
MustAssignEntityContextInitializeContext=必须指定 EntityContextInitializeContext 对象。
TreeCodeOutOfRange=末级编码超出预设的{0}位编码。